1111111111
2212121212
3221212123
3212313123
1312213123
1231233213
1231231231
3121231113
3333123333
2222222222